5
....o.o.
..oo....
o..o....
.ooo...o
..o..o..
